                                                                                                                                                              
  ¡ó      ¡ó¡ó¡ó¡ó¡ó              ¡ó¡ó¡ó  ¡ó¡ó¡ó¡ó¡ó                                                                          ¡ó¡ó¡ó¡ó¡ó                      
  ¡ó      ¡ó      ¡ó              ¡ó  ¡ó  ¡ó      ¡ó                                                                          ¡ó      ¡ó                      
  ¡ó      ¡ó¡ó¡ó  ¡ó              ¡ó  ¡ó¡ó¡ó      ¡ó          ¡ó¡ó¡ó                  ¡ó¡ó¡ó                          ¡ó¡ó¡ó¡ó¡ó      ¡ó                      
  ¡ó          ¡ó  ¡ó              ¡ó              ¡ó          ¡ó  ¡ó                  ¡ó  ¡ó                          ¡ó              ¡ó                      
  ¡ó¡ó¡ó      ¡ó  ¡ó              ¡ó¡ó¡ó          ¡ó  ¡ó¡ó¡ó¡ó¡ó  ¡ó¡ó¡ó          ¡ó¡ó¡ó  ¡ó¡ó¡ó¡ó¡ó                  ¡ó          ¡ó¡ó¡ó      ¡ó¡ó¡ó¡ó¡ó      
      ¡ó      ¡ó  ¡ó                  ¡ó          ¡ó  ¡ó              ¡ó          ¡ó              ¡ó                  ¡ó          ¡ó          ¡ó      ¡ó      
      ¡ó      ¡ó  ¡ó¡ó¡ó          ¡ó¡ó¡ó          ¡ó¡ó¡ó              ¡ó          ¡ó              ¡ó¡ó¡ó              ¡ó¡ó¡ó  ¡ó¡ó¡ó          ¡ó      ¡ó      
      ¡ó      ¡ó      ¡ó          ¡ó                                  ¡ó          ¡ó                  ¡ó                  ¡ó  ¡ó              ¡ó      ¡ó      
      ¡ó¡ó¡ó¡ó¡ó      ¡ó          ¡ó¡ó¡ó                              ¡ó          ¡ó                  ¡ó          ¡ó¡ó¡ó¡ó¡ó  ¡ó¡ó¡ó          ¡ó      ¡ó¡ó¡ó  
                      ¡ó              ¡ó                              ¡ó          ¡ó                  ¡ó          ¡ó              ¡ó          ¡ó          ¡ó  
                  ¡ó¡ó¡ó              ¡ó¡ó¡ó                          ¡ó          ¡ó  ¡ó¡ó¡ó          ¡ó          ¡ó          ¡ó¡ó¡ó      ¡ó¡ó¡ó      ¡ó¡ó¡ó  
                  ¡ó                      ¡ó                          ¡ó          ¡ó  ¡ó  ¡ó          ¡ó          ¡ó          ¡ó          ¡ó          ¡ó      
          ¡ó¡ó¡ó  ¡ó                      ¡ó¡ó¡ó¡ó¡ó¡ó¡ó¡ó¡ó          ¡ó¡ó¡ó  ¡ó¡ó¡ó  ¡ó  ¡ó¡ó¡ó  ¡ó¡ó¡ó      ¡ó¡ó¡ó          ¡ó          ¡ó          ¡ó      
          ¡ó  ¡ó  ¡ó                                      ¡ó              ¡ó  ¡ó      ¡ó      ¡ó  ¡ó          ¡ó              ¡ó          ¡ó          ¡ó      
      ¡ó¡ó¡ó  ¡ó¡ó¡ó              ¡ó¡ó¡ó                  ¡ó¡ó¡ó¡ó¡ó      ¡ó  ¡ó¡ó¡ó¡ó¡ó      ¡ó  ¡ó          ¡ó          ¡ó¡ó¡ó          ¡ó¡ó¡ó      ¡ó¡ó¡ó  
      ¡ó                          ¡ó  ¡ó                          ¡ó      ¡ó                  ¡ó  ¡ó          ¡ó          ¡ó                  ¡ó          ¡ó  
  ¡ó¡ó¡ó      ¡ó¡ó¡ó¡ó¡ó¡ó¡ó      ¡ó  ¡ó                          ¡ó      ¡ó          ¡ó¡ó¡ó¡ó¡ó  ¡ó      ¡ó¡ó¡ó          ¡ó¡ó¡ó¡ó¡ó          ¡ó      ¡ó¡ó¡ó  
  ¡ó          ¡ó          ¡ó      ¡ó  ¡ó                          ¡ó      ¡ó          ¡ó          ¡ó      ¡ó                      ¡ó          ¡ó      ¡ó      
  ¡ó          ¡ó¡ó¡ó      ¡ó      ¡ó  ¡ó¡ó¡ó¡ó¡ó¡ó¡ó              ¡ó      ¡ó      ¡ó¡ó¡ó          ¡ó¡ó¡ó¡ó¡ó                      ¡ó          ¡ó      ¡ó      
  ¡ó              ¡ó      ¡ó      ¡ó              ¡ó              ¡ó      ¡ó      ¡ó                                              ¡ó          ¡ó      ¡ó      
  ¡ó              ¡ó¡ó¡ó  ¡ó      ¡ó              ¡ó              ¡ó      ¡ó  ¡ó¡ó¡ó                                          ¡ó¡ó¡ó      ¡ó¡ó¡ó      ¡ó      
  ¡ó                  ¡ó  ¡ó      ¡ó              ¡ó              ¡ó      ¡ó  ¡ó                                              ¡ó          ¡ó          ¡ó      
  ¡ó              ¡ó¡ó¡ó  ¡ó¡ó¡ó  ¡ó¡ó¡ó¡ó¡ó      ¡ó              ¡ó      ¡ó¡ó¡ó                              ¡ó¡ó¡ó¡ó¡ó      ¡ó¡ó¡ó  ¡ó¡ó¡ó          ¡ó      
  ¡ó              ¡ó          ¡ó          ¡ó      ¡ó              ¡ó                                          ¡ó      ¡ó          ¡ó  ¡ó              ¡ó      
  ¡ó¡ó¡ó          ¡ó¡ó¡ó      ¡ó          ¡ó      ¡ó          ¡ó¡ó¡ó                              ¡ó¡ó¡ó¡ó¡ó¡ó¡ó      ¡ó¡ó¡ó      ¡ó¡ó¡ó          ¡ó¡ó¡ó      
      ¡ó              ¡ó      ¡ó          ¡ó      ¡ó          ¡ó                                  ¡ó                      ¡ó                      ¡ó          
      ¡ó              ¡ó      ¡ó      ¡ó¡ó¡ó      ¡ó¡ó¡ó      ¡ó                                  ¡ó¡ó¡ó                  ¡ó                      ¡ó          
      ¡ó              ¡ó      ¡ó      ¡ó              ¡ó      ¡ó                                      ¡ó                  ¡ó                      ¡ó          
      ¡ó              ¡ó      ¡ó  ¡ó¡ó¡ó      ¡ó¡ó¡ó¡ó¡ó      ¡ó                                      ¡ó                  ¡ó                      ¡ó          
      ¡ó              ¡ó      ¡ó  ¡ó          ¡ó              ¡ó                                      ¡ó                  ¡ó                      ¡ó          
      ¡ó¡ó¡ó          ¡ó      ¡ó¡ó¡ó          ¡ó              ¡ó¡ó¡ó                                  ¡ó¡ó¡ó              ¡ó¡ó¡ó                  ¡ó          
          ¡ó          ¡ó                      ¡ó                  ¡ó                                      ¡ó                  ¡ó                  ¡ó          
          ¡ó      ¡ó¡ó¡ó                      ¡ó                  ¡ó              ¡ó¡ó¡ó                  ¡ó¡ó¡ó              ¡ó              ¡ó¡ó¡ó  ¡ó¡ó¡ó  
          ¡ó      ¡ó                          ¡ó                  ¡ó              ¡ó  ¡ó                      ¡ó              ¡ó              ¡ó      ¡ó  ¡ó  
          ¡ó      ¡ó                          ¡ó¡ó¡ó¡ó¡ó¡ó¡ó      ¡ó              ¡ó  ¡ó¡ó¡ó¡ó¡ó¡ó¡ó      ¡ó¡ó¡ó              ¡ó      ¡ó¡ó¡ó¡ó¡ó      ¡ó  ¡ó  
          ¡ó      ¡ó                                      ¡ó      ¡ó              ¡ó              ¡ó      ¡ó                  ¡ó      ¡ó              ¡ó  ¡ó  
          ¡ó      ¡ó                                  ¡ó¡ó¡ó      ¡ó  ¡ó¡ó¡ó¡ó¡ó¡ó¡ó  ¡ó¡ó¡ó¡ó¡ó  ¡ó¡ó¡ó  ¡ó      ¡ó¡ó¡ó¡ó¡ó  ¡ó  ¡ó¡ó¡ó      ¡ó¡ó¡ó¡ó¡ó  ¡ó  
          ¡ó      ¡ó                                  ¡ó          ¡ó  ¡ó              ¡ó      ¡ó      ¡ó  ¡ó      ¡ó      ¡ó  ¡ó  ¡ó          ¡ó          ¡ó  
          ¡ó      ¡ó                                  ¡ó          ¡ó  ¡ó¡ó¡ó      ¡ó¡ó¡ó  ¡ó¡ó¡ó      ¡ó¡ó¡ó  ¡ó¡ó¡ó      ¡ó  ¡ó¡ó¡ó          ¡ó          ¡ó  
          ¡ó      ¡ó                                  ¡ó          ¡ó      ¡ó      ¡ó      ¡ó                  ¡ó          ¡ó                  ¡ó          ¡ó  
          ¡ó      ¡ó                                  ¡ó      ¡ó¡ó¡ó  ¡ó¡ó¡ó  ¡ó¡ó¡ó  ¡ó¡ó¡ó  ¡ó¡ó¡ó          ¡ó          ¡ó                  ¡ó          ¡ó  
          ¡ó      ¡ó                                  ¡ó      ¡ó      ¡ó      ¡ó      ¡ó      ¡ó  ¡ó          ¡ó          ¡ó                  ¡ó          ¡ó  
          ¡ó      ¡ó                              ¡ó¡ó¡ó      ¡ó      ¡ó¡ó¡ó¡ó¡ó      ¡ó¡ó¡ó¡ó¡ó  ¡ó  ¡ó¡ó¡ó¡ó¡ó          ¡ó                  ¡ó¡ó¡ó      ¡ó  
          ¡ó      ¡ó                              ¡ó          ¡ó                                  ¡ó  ¡ó                  ¡ó                      ¡ó      ¡ó  
  ¡ó¡ó¡ó¡ó¡ó      ¡ó                              ¡ó          ¡ó          ¡ó¡ó¡ó¡ó¡ó              ¡ó  ¡ó                  ¡ó              ¡ó¡ó¡ó¡ó¡ó      ¡ó  
  ¡ó              ¡ó                              ¡ó          ¡ó          ¡ó      ¡ó              ¡ó  ¡ó                  ¡ó              ¡ó              ¡ó  
  ¡ó              ¡ó¡ó¡ó                          ¡ó          ¡ó          ¡ó      ¡ó¡ó¡ó¡ó¡ó¡ó¡ó¡ó¡ó  ¡ó          ¡ó¡ó¡ó¡ó¡ó              ¡ó          ¡ó¡ó¡ó  
  ¡ó                  ¡ó                          ¡ó          ¡ó          ¡ó                          ¡ó          ¡ó                      ¡ó          ¡ó      
  ¡ó                  ¡ó                          ¡ó          ¡ó      ¡ó¡ó¡ó                          ¡ó      ¡ó¡ó¡ó                  ¡ó¡ó¡ó          ¡ó      
  ¡ó                  ¡ó                          ¡ó          ¡ó      ¡ó                              ¡ó      ¡ó                      ¡ó              ¡ó      
  ¡ó¡ó¡ó              ¡ó                          ¡ó¡ó¡ó      ¡ó      ¡ó¡ó¡ó                          ¡ó  ¡ó¡ó¡ó                      ¡ó              ¡ó      
      ¡ó              ¡ó                              ¡ó      ¡ó          ¡ó                          ¡ó  ¡ó                          ¡ó              ¡ó      
  ¡ó¡ó¡ó              ¡ó                              ¡ó      ¡ó          ¡ó                      ¡ó¡ó¡ó  ¡ó                          ¡ó¡ó¡ó  ¡ó¡ó¡ó  ¡ó      
  ¡ó                  ¡ó                              ¡ó      ¡ó          ¡ó                      ¡ó      ¡ó                              ¡ó  ¡ó  ¡ó  ¡ó      
  ¡ó¡ó¡ó          ¡ó¡ó¡ó                              ¡ó      ¡ó          ¡ó¡ó¡ó¡ó¡ó              ¡ó¡ó¡ó  ¡ó                              ¡ó  ¡ó  ¡ó¡ó¡ó      
      ¡ó          ¡ó                                  ¡ó      ¡ó                  ¡ó                  ¡ó  ¡ó                              ¡ó  ¡ó              
      ¡ó          ¡ó                                  ¡ó      ¡ó                  ¡ó                  ¡ó  ¡ó                              ¡ó  ¡ó¡ó¡ó          
      ¡ó          ¡ó                                  ¡ó      ¡ó                  ¡ó                  ¡ó  ¡ó                              ¡ó      ¡ó          
      ¡ó          ¡ó¡ó¡ó                              ¡ó      ¡ó                  ¡ó                  ¡ó  ¡ó                              ¡ó      ¡ó          
      ¡ó              ¡ó                              ¡ó      ¡ó                  ¡ó                  ¡ó  ¡ó                              ¡ó      ¡ó          
      ¡ó              ¡ó                              ¡ó      ¡ó  ¡ó¡ó¡ó¡ó¡ó      ¡ó¡ó¡ó              ¡ó  ¡ó¡ó¡ó                          ¡ó  ¡ó¡ó¡ó          
      ¡ó              ¡ó                              ¡ó      ¡ó  ¡ó      ¡ó          ¡ó              ¡ó      ¡ó                          ¡ó  ¡ó              
      ¡ó              ¡ó          ¡ó¡ó¡ó¡ó¡ó¡ó¡ó      ¡ó      ¡ó¡ó¡ó      ¡ó  ¡ó¡ó¡ó¡ó¡ó              ¡ó      ¡ó                          ¡ó  ¡ó¡ó¡ó          
      ¡ó              ¡ó          ¡ó          ¡ó      ¡ó                  ¡ó  ¡ó                      ¡ó      ¡ó                          ¡ó      ¡ó          
      ¡ó¡ó¡ó          ¡ó¡ó¡ó      ¡ó          ¡ó      ¡ó                  ¡ó  ¡ó¡ó¡ó                  ¡ó      ¡ó¡ó¡ó                      ¡ó¡ó¡ó  ¡ó¡ó¡ó¡ó¡ó  
          ¡ó              ¡ó      ¡ó          ¡ó      ¡ó                  ¡ó      ¡ó                  ¡ó          ¡ó                          ¡ó          ¡ó  
          ¡ó          ¡ó¡ó¡ó      ¡ó          ¡ó      ¡ó                  ¡ó¡ó¡ó  ¡ó¡ó¡ó              ¡ó          ¡ó                          ¡ó          ¡ó  
          ¡ó          ¡ó          ¡ó          ¡ó      ¡ó                      ¡ó      ¡ó              ¡ó          ¡ó                          ¡ó          ¡ó  
          ¡ó      ¡ó¡ó¡ó          ¡ó          ¡ó      ¡ó                      ¡ó      ¡ó              ¡ó          ¡ó¡ó¡ó      ¡ó¡ó¡ó          ¡ó¡ó¡ó      ¡ó  
          ¡ó      ¡ó              ¡ó          ¡ó      ¡ó                      ¡ó      ¡ó              ¡ó              ¡ó      ¡ó  ¡ó              ¡ó      ¡ó  
          ¡ó      ¡ó¡ó¡ó          ¡ó          ¡ó      ¡ó  ¡ó¡ó¡ó¡ó¡ó  ¡ó¡ó¡ó¡ó¡ó      ¡ó          ¡ó¡ó¡ó          ¡ó¡ó¡ó      ¡ó  ¡ó  ¡ó¡ó¡ó¡ó¡ó  ¡ó      ¡ó  
          ¡ó          ¡ó          ¡ó          ¡ó      ¡ó  ¡ó      ¡ó  ¡ó              ¡ó          ¡ó              ¡ó          ¡ó  ¡ó  ¡ó      ¡ó  ¡ó      ¡ó  
          ¡ó          ¡ó          ¡ó          ¡ó¡ó¡ó  ¡ó  ¡ó      ¡ó¡ó¡ó          ¡ó¡ó¡ó      ¡ó¡ó¡ó              ¡ó          ¡ó  ¡ó¡ó¡ó      ¡ó¡ó¡ó  ¡ó¡ó¡ó  
          ¡ó          ¡ó          ¡ó              ¡ó  ¡ó  ¡ó                      ¡ó          ¡ó                  ¡ó          ¡ó                      ¡ó      
          ¡ó      ¡ó¡ó¡ó          ¡ó¡ó¡ó          ¡ó¡ó¡ó  ¡ó                      ¡ó          ¡ó          ¡ó¡ó¡ó¡ó¡ó          ¡ó                      ¡ó      
          ¡ó      ¡ó                  ¡ó                  ¡ó                      ¡ó          ¡ó          ¡ó                  ¡ó                      ¡ó      
          ¡ó¡ó¡ó¡ó¡ó                  ¡ó¡ó¡ó¡ó¡ó¡ó¡ó¡ó¡ó¡ó¡ó                      ¡ó¡ó¡ó¡ó¡ó¡ó¡ó          ¡ó¡ó¡ó¡ó¡ó¡ó¡ó¡ó¡ó¡ó¡ó                      ¡ó¡ó¡ó  
                                                                                                                                                              
