1
XXXXXXXXXXXXXXXXXXXXXXXXXXXXXXXXXXXXXXXXXXXXXXXXXXXXXXXXXXXXXXXXXXXXXXXXXXXXXXXXXXXXXXXXXXXXXXXXXXXXX
X.X...X...........X.....X.........X.....................X.......X...........X...X...X...............X
X.XXX.X.XXXXXXX.X.X.X.XXX.XXX.X.X.X.XXX.XXXXXXXXXXXXXXX.XXX.X.XXX.XXX.XXXXX.X.XXX.X.X.XXXXX.XXXXXXX.X
X...X...X.......X.X.X.X...X.X.X.X...X...X.........X...X...X.X.X.....X...X.....X...X...X...X.X.......X
XXX.X.XXX.XXXXXXX.X.X.X.XXX.X.XXXXXXX.XXX.XXXXXXX.XXX.XXX.XXX.X.XXXXXXX.X.XXXXX.XXXXXXX.X.XXX.XXXXX.X
X...X...X.X...X...X.X.X...X.X.....X...X.X.X.Xo..X.X.....X.X...X...X.....X.....X.X.X...X.X.....X...X.X
X.XXXXXXX.XXX.X.XXX.XXXXX.X.XXXXX.XXX.X.X.X.X.X.X.X.X.XXX.X.XXXXX.X.XXXXXXXXX.X.X.XXX.X.XXX.X.X.X.XXX
X...X.....X...X.X...........X...X...X.X.X.X...X.X.X.X.X...X.......X.....X...X.X.X.....X...X.X.X.X...X
XXX.X.XXXXX.X.X.XXXXX.XXXXX.X.XXXXX.X.X.X.XXXXX.X.X.X.X.XXXXXXX.XXXXXXX.X.X.XXX.X.XXX.XXX.XXXXX.XXX.X
X...X.....X.X.X.X...X...X.X.X.....X.X...X...X...X.X.X.X.......X.X.....X.X.X.X...X.X...X.X.......X...X
X.XXXXXXX.X.XXX.X.X.XXXXX.X.XXXXX.X.XXXXXXX.X.XXX.X.XXXXXXXXX.XXX.XXX.X.X.X.X.XXX.X.XXX.XXXXXXXXX.XXX
X.......X.X...X...X.....X.X.X...X.X...X.....X...X.X...X...X...X...X.X...X.X...X...X.X...........X...X
XXXXXXX.X.XXX.XXXXXXXXX.X.X.X.X.X.XXX.X.XXXXX.X.X.XXX.XXX.X.XXX.XXX.XXX.X.XXXXX.XXX.X.XXX.XXXXXXXXX.X
X.....X.X...X...X.X.....X.X...X.X...X...X.....X.X...X.....X.....X.....X.X...X...X.X...X.....X.......X
X.XXXXX.XXX.X.X.X.X.XXXXX.XXXXX.X.X.XXXXXXXXX.X.XXX.X.X.XXXXXXXXX.X.XXX.XXX.XXX.X.XXXXX.XXXXX.XXXXXXX
X.X...X.....X.X...X.X.X.......X...X.X.........X.X.X.X.X.......X...X...X.X.X.X...X...X...X.X.X.......X
X.X.X.XXXXXXX.XXXXX.X.X.XXXXX.XXXXX.X.XXXXXXXXX.X.X.X.XXXXX.X.X.XXXXX.X.X.X.X.XXX.X.X.XXX.X.XXXXXXX.X
X...X.......X.......X.X.X.........X.X...X.....X...X.X.X.X...X.X...X.X.....X...X...X.X...........X...X
X.XXXXXXX.X.X.XXXXXXX.X.X.XXXXXXX.X.XXX.X.XXX.XXX.X.X.X.X.XXXXXXX.X.XXXXXXXXXXXXX.X.XXXXX.XXXXXXX.X.X
X...X...X.X.X...X.......X.......X.X...X.X.X...X...X.X...X.......X.X...X.......X...X.X.....X.......X.X
XXX.X.X.XXX.XXX.X.XXXXXXX.XXXXX.XXXXX.X.X.X.XXX.XXX.XXX.XXXXX.XXX.X.X.X.XXX.X.X.XXXXX.XXXXX.XXXXXXX.X
X.X.X.X.....X...X...X...X.....X.....X.X...X...X...X.X.......X.......X.X...X.X...X.....X...X.X.X.....X
X.X.X.XXXXX.X.XXXXXXX.X.XXXXX.X.XXX.X.XXXXXXX.X.XXX.XXXXXXXXXXXXXXXXXXXXX.X.XXXXX.XXXXXXX.X.X.X.XXXXX
X...X.X...X.X.........X.....X.X.X...X.X...X...X.X...X.................X...X.X.....X.......X.X...X...X
XXXXX.XXX.X.XXXXXXXXXXXXXXX.X.X.XXXXX.X.X.X.XXXXX.XXX.X.XXXXXXXXXXXXX.X.XXX.X.XXXXX.XXX.XXX.X.XXX.X.X
X.....X...X...X...X.......X.X.X...X...X.X.X.X...X.....X.X...X...X.....X...X.X.X.......X.X...X.....X.X
XXX.XXX.XXXXX.X.X.X.XXXXX.X.XXXXX.X.XXX.X.X.X.X.XXXXXXX.X.X.X.X.X.XXXXXXX.X.X.XXXXXXX.X.X.XXXXXXXXX.X
X...X.......X...X.X.X.X...X.....X...X...X...X.X.......X...X.X.X.X.....X...X...........X.X.X.......X.X
X.XXXXXXXXX.XXXXX.X.X.X.XXXXXXX.X.XXXXX.X.XXX.XXXXXXX.XXXXXXX.X.X.X.X.X.XXXXXXXXXXXXXXX.X.X.XXX.XXX.X
X.X.......X.......X...X.....X...X...X...X.X...X.X.X.X.X.......X.X.X.X...X.......X...X...X.X.X.X...X.X
X.X.XXXXX.X.XXXXXXX.XXXXX.XXX.XXXXX.X.X.XXX.XXX.X.X.X.X.XXXXXXX.XXXXX.XXX.XXXXX.X.X.X.XXX.X.X.XXX.X.X
X.......X.X.X.....X.X...X.X...X...X...X.X...X.......X...X.....X.....X...X...X.X.X.X...X...X.X...X...X
X.XXXXXXX.X.XXX.X.X.XXX.X.X.XXX.X.XXX.XXX.XXX.XXXXX.XXXXXXX.X.XXXXX.XXX.XXX.X.X.X.XXXXX.XXX.XXX.XXXXX
X.X.X.....X.....X.X.X...X...X...X.....X...X...X.X...X.....X.X.....X.X.X.X.X.X.X.X.X.....X.X...X.....X
X.X.X.XXXXXXXXXXX.X.X.XXXXX.XXXXXXXXXXX.XXX.X.X.X.XXXXX.X.XXXXXXX.X.X.X.X.X.X.X.XXX.XXXXX.XXX.X.XXX.X
X...X.X...X.......X.X.....X.X.......X...X...X.X...X.X...X.........X.X...X.X.X.......X...X.....X...X.X
X.X.X.XXX.X.XXXXX.X.X.XXX.XXX.XXX.X.X.XXX.XXX.XXX.X.X.XXXXXXXXXXX.X.XXX.X.X.XXXXXXXXX.X.X.XXXXXXX.X.X
X.X.X...X...X...X.X.X...X.X...X...X...X.....X...X...X.X.......X...X...X...X.....X.....X...X.......X.X
XXXXXXX.XXXXX.X.X.X.XXX.X.X.X.XXXXXXXXXXXXXXX.X.XXX.X.X.XXXXX.X.XXXXX.X.XXXXXXX.XXXXX.XXXXX.XXXXX.XXX
X.....X.......X.X.X.X...X...X.........X.....X.X...X...X.X.....X...X...X.X.....X.....X.X.....X.X.X...X
X.XXX.XXXXXXXXX.XXX.XXX.XXXXXXXXXXXXX.X.XXX.XXX.X.XXXXX.X.XXXXX.XXX.XXXXX.XXX.XXXXX.X.XXX.XXX.X.XXX.X
X.X.X...X...X.X...X...X.......X.....X.X...X.X...X.X.....X.....X.X...X.....X...X.....X.....X.......X.X
X.X.XXX.X.X.X.X.X.XXX.XXX.XXXXX.XXX.X.XXX.X.XXXXX.XXX.XXXXXXX.X.X.XXX.XXXXX.XXX.XXXXXXXXXXX.XXX.XXX.X
X.X...X...X.X.X.X...X.X.....X...X.X...X...X.......X...X.......X.X.X.....X...X...X.............X.X...X
X.XXX.XXXXX.X.X.XXX.X.XXX.XXX.XXX.XXXXX.XXXXXXXXXXX.XXXXXXXXXXX.X.XXXXX.XXX.X.XXXXX.XXXXXXX.X.X.X.XXX
X...X.....X.X.....X.X...X.X...X.......X.X.....X...X.....X.....X.X.....X...X...X...X.X.....X.X.X.X...X
X.X.XXXXX.X.XXXXX.X.XXX.XXX.XXX.XXXXX.X.X.XXXXX.X.XXXXX.X.XXX.X.XXXXX.X.X.XXXXX.XXX.X.XXX.XXX.X.XXX.X
X.X...X...X.X.....X...X.....X...X.......X.......X.....X.X.X.X...X.X...X.X.X.....X...X...X...X.X...X.X
X.XXX.XXX.X.XXXXXXX.X.XXXXXXXXX.XXXXX.XXXXXXX.XXX.XXX.X.X.X.XXXXX.X.XXXXX.X.X.XXX.XXXXX.XXX.X.XXX.X.X
X...X...X.X...X...X.X.X.........X...X.X.....X.X.X.X.....X.X.......X.X.....X.X...X.X...X...X...X...X.X
XXX.XXX.X.XXX.X.X.XXX.XXXXXXX.X.X.X.XXX.XXX.X.X.X.XXXXXXX.X.XXXXX.X.X.XXXXXXX.X.X.XXX.XXX.XXXXX.XXX.X
X...X...X.....X.X.........X...X.X.X.......X.X.X.X.X.....X.X.X.....X...X.......X.X.......X.....X.X.X.X
X.XXX.XXXXXXX.X.XXXXXXXXX.X.X.XXX.XXXXXXXXX.X.X.X.X.XXX.X.X.X.XXXXXXXXXXXXX.XXX.XXXXXXX.XXXXX.X.X.X.X
X.X.X.......X.X.....X...X.X.X.X...X.X.....X.X...X.....X.X.X.X.........X.....X.X.....X.X.X.X...X...X.X
X.X.XXXXXXX.X.XXXXX.X.XXX.X.XXX.XXX.X.XXX.X.XXX.XXXXXXX.X.XXXXXXX.XXX.X.XXXXX.XXXXX.X.X.X.X.XXXXXXX.X
X.....X.....X.......X.......X...X.....X...X...X...X.....X.X.......X...X...X.X.....X.X.X.X.X.X.......X
X.XXXXX.XXXXX.XXXXXXXXXXXXXXX.XXXXX.XXXXXXXXX.X.XXX.XXXXX.X.XXXXXXX.XXX.X.X.X.XXX.X.X.X.X.X.X.XXXXXXX
X.X.....X.....X...........X...X.....X.....X...X.X.X...X...X.......X.X.X.X.X.....X.....X.X.X.X...X...X
X.X.XXX.XXXXXXX.XXXXX.XXX.X.XXX.XXX.X.XXX.X.XXX.X.XXX.X.XXX.XXXXX.X.X.X.X.XXXXX.XXXXXXX.X.X.XXX.XXX.X
X.X.X...X.....X.X...X.X...X.X...X...X.X.X...X...X...X...X.....X...X.X...X.....X...X.....X.X.....X...X
XXX.XXXXX.XXX.X.X.X.XXX.X.X.XXX.X.XXX.X.XXXXX.XXX.XXXXXXXXXXX.X.XXX.XXXXXXXXX.X.XXX.XXXXX.XXXXXXX.X.X
X.X...X...X...X.X.X.....X.X.....X...X.X.......X...X.X.......X.X.X.X...........X.X...X...X.........X.X
X.X.X.X.XXX.XXX.X.XXX.XXXXXXX.XXXXXXX.XXXXXXX.XXX.X.X.X.XXX.XXX.X.XXXXXXXXX.XXXXX.XXX.X.XXXXX.XXXXXXX
X.X.X.X.X...X...X...X.X.......X.......X.....X.....X...X...X.X...X.......X.....X...X...X.....X.X.....X
X.X.X.X.X.X.X.XXXXX.X.X.XXXXXXX.XXXXXXX.XXX.XXXXX.XXXXX.X.X.X.XXXXX.XXXXX.XXXXX.XXX.XXXXXXX.X.X.X.X.X
X...X.X.X.X.X.....X.X.X.X.....X...........X...X...X...X.X.X.X.....X...X...X.X...X...X.....X.X...X.X.X
X.XXX.X.X.XXXXX.XXX.XXX.X.XXX.XXXXXXXXXXXXXXX.X.XXX.X.X.X.X.XXXXX.X.X.X.XXX.X.XXX.XXX.X.XXX.X.XXXXX.X
X.X.X...X.......X.....X.X.X.X...X.......X...X.X.....X.X.X.X.....X.X.X.......X.....X.X.X...X.X...X...X
X.X.XXXXXXXXXXXXX.XXXXX.X.X.XXX.XXX.XXX.X.X.X.XXXXXXX.X.X.XXXXX.X.X.XXXXXXXXXXXXXXX.XXXXX.X.X.XXX.X.X
X...X...........X...X...X...X.X.X.....X.X.X.X...X...X.X.X.....X...X.X.X.............X.....X.X.X...X.X
XXX.X.XXXXXXXXX.XXX.X.XXXXX.X.X.X.XXXXX.X.X.X.X.X.XXX.X.XXXXX.XXXXX.X.X.XXXXXXX.XXX.X.XXXXX.XXX.XXX.X
X...X...X.....X...X.X.X...X...X.....X...X.X.X.X.X.X...X.X...X.X...X.X.X.X...X...X...X.X.....X...X...X
X.XXXXX.X.X.XXXXX.X.X.X.X.XXXXXXXXXXX.XXX.X.XXX.X.X.XXXXX.X.X.X.XXX.X.X.XXX.X.XXX.XXX.X.XXXXX.XXXXX.X
X...X...X.X.......X.....X.X...X.......X...X.....X...X.....X...X...X.X.X.X...X.X...X...X.....X.....X.X
XXX.X.XXX.XXXXXXXXXXXXXXX.X.X.X.XXXXX.X.XXXXXXXXX.XXX.X.XXX.XXXXX.X.X.X.X.XXX.XXX.X.X.XXXXX.XXXXX.X.X
X.X.X.X...X...X...X...X.....X...X...X.X.....X.........X.X...X...X.....X.X...X...X.X.X.....X.X.....X.X
X.X.X.XXXXX.X.X.X.X.X.XXXXXXXXXXX.X.X.XXXXX.XXXXXXXXX.XXXXXXX.X.XXXXXXX.XXX.XXX.X.X.XXXXX.X.X.XXXXXXX
X...X.X...X.X...X.X.X.X...........X.X.X.X...X.....X.X.X.......X...X.....X.....X.X.X.X...X.X.X.......X
X.XXX.X.X.X.XXXXX.XXX.X.XXXXXXXXXXX.X.X.X.XXX.XXX.X.X.X.XXXXXXXXX.X.XXXXX.XXX.X.X.X.X.X.XXX.XXXXXXX.X
X...X...X...X.....X...X.X...X.X.....X...X.......X.X.X.X.X.......X...X.....X.X.X.X...X.X...X.X.....X.X
XXX.XXXXXXXXX.XXX.X.X.X.X.X.X.X.XXX.XXXXXXXXXXXXX.X.X.X.XXX.X.XXXXXXX.XXX.X.X.X.X.XXX.XXX.X.X.XXX.X.X
X.X.......X...X.X...X.X...X.X.....X...........X...X...X...X.X.........X.X.X...X.X.X...X.X...X.X...X.X
X.XXXXXXX.X.XXX.XXXXX.XXXXX.X.XXXXXXXXXXXXXXX.X.XXXXX.XXX.XXX.XXXXXXXXX.X.X.XXX.XXX.XXX.XXXXX.X.XXX.X
X.....X.X...X.......X.X.X...X...X.......X...X.X.X...X.X.X...X.......X...X.X.X...X...X.........X.X...X
X.X.X.X.XXXXX.XXXXX.X.X.X.XXXXX.X.XXXXX.XXX.X.X.X.X.X.X.X.XXXXXXXXX.X.X.X.XXX.XXX.XXXXX.X.XXXXX.X.X.X
X.X.X.X...X.X...X.X...X.X.X...X.X.X...X...X.X.X...X.X...X...X.....X...X.X...X.....X.X...X.X...X.X.X.X
XXX.X.X.X.X.XXX.X.XXXXX.X.X.X.XXX.X.XXXXX.X.X.XXXXX.X.XXXXX.X.X.XXXXXXX.XXX.XXXXXXX.X.XXX.X.XXX.XXX.X
X...X...X.X...X...X.....X...X...X...X.....X.........X...X...X.X.........X.X.........X.X.X.X...X...X.X
X.XXXXXXX.XXX.XXX.XXX.X.XXXXXXX.XXX.X.X.XXXXXXX.XXXXXXX.X.XXXXXXX.XXXXXXX.XXX.X.XXXXX.X.X.XXX.XXX.X.X
X.X.....X.......X...X.X.......X.....X.X.X...X...X...X...X.X.....X...X.....X.X.X.....X...X...X.....X.X
X.X.XXX.XXXXXXX.XXX.X.XXXXXXX.XXXXXXX.XXX.X.X.XXX.X.XXXXX.X.XXX.XXX.XXX.X.X.XXXXX.X.XXX.XXX.X.XXXXX.X
X...X.X...X...X...X.X.......X...X.X.....X.X.X...X.X.....X.X.X.X.X.X.X...X...X...X.X...X...X.X...X...X
X.XXX.XXX.X.X.XXX.X.X.XXXXX.XXX.X.X.XXX.X.X.XXXXX.XXX.X.X.X.X.X.X.X.X.XXXXX.X.X.XXX.XXXXX.X.XXX.XXX.X
X.......X.X.X.....X.X.X...X...X...X.X.X.X.X.......X...X.X.X.X...X.....X.....X.X.X.........X.X.X...X.X
XXXXXXXXX.X.XXXXXXX.X.X.XXXXX.XXXXX.X.X.X.XXXXXXXXX.XXXXX.X.XXX.XXXXXXX.XXXXX.X.X.XXXXXXX.X.X.XXX.X.X
X.........X.X...X...X...X.....X.X...X...X...X...X.....X...X...X.X.....X.....X.X.X.X.....X.X.X.X.X.X.X
X.XXX.XXXXX.X.XXX.XXXXX.X.XXX.X.X.X.XXXXXXX.XXX.X.XXXXX.XXXXX.X.X.XXX.X.XXXXX.X.XXX.XXX.XXX.X.X.X.X.X
X.X...X...X.....X.X...X.X.X.X...X.X.X.....X.X...X.....X.X.....X...X.X.X.X...X.X.....X.X.....X.......X
X.XXXXX.X.XXXXXXX.X.X.XXX.X.XXX.X.XXX.XXX.X.X.X.XXXXX.X.X.XXXXXXXXX.X.XXX.X.X.XXXXXXX.XXXXXXX.XXXXXXX
X.......X...........X.....X.....X.......X.....X.....X.....X...............X...X.....................X
XXXXXXXXXXXXXXXXXXXXXXXXXXXXXXXXXXXXXXXXXXXXXXXXXXXXXXXXXXXXXXXXXXXXXXXXXXXXXXXXXXXXXXXXXXXXXXXXXXXXX
2
XXXXXXXXXXXXXXXXXXXXXXXXXXXXXXXXXXXXXXXXXXXXXXXXXXXXXXXXXXXXXXXXXXXXXXXXXXXXXXXXXXXXXXXXXXXXXXXXXXXXX
X.........X...........X.....X.............X...X.........X.......X.....X.............................X
X.X.XXXXX.X.XXXXX.XXX.X.X.X.X.X.XXXXXXXXXXX.X.XXXXX.XXX.X.XXXXX.XXX.X.XXX.XXXXXXXXX.XXXXXXXXXXXXXXX.X
X.X.X...X.X.X.....X...X.X.X.X.X.....X.......X...X.X...X.......X.X...X.....X.......X.X...X...........X
X.X.XXX.X.X.X.XXXXX.XXX.X.X.XXXXXXX.X.XXXXXXXXX.X.XXX.XXXXXXX.X.X.XXXXXXXXX.XXXXXXX.X.X.XXXXXXXXX.XXX
X.X...X...X.X...X.X...X.X.X.........X.X.X....o..X...........X.X...X.................X.X.........X...X
XXXXX.X.XXXXXXX.X.XXX.XXX.XXXXX.XXXXX.X.X.XXXXXXXXXXXXXXXXX.X.XXXXXXXXX.XXXXX.XXXXXXX.XXXXXXXXX.XXX.X
X.....X.....X...X...X.....X...X.X.X...X.X.X...X...........X.X.....X...X.X...X.X.....X.X.....X...X.X.X
X.XXXXXXXXX.XXX.X.XXXXXXXXXXX.X.X.X.XXX.X.X.X.X.XXXXXXX.X.X.XXXXX.X.X.XXX.X.X.X.XXX.X.X.XXXXX.XXX.X.X
X.X...X...X.X...X.X.....X.....X.X.X.X...X.X.X...X.X.....X.X.....X...X...X.X.X.X...X...X...X...X.X...X
X.X.X.X.X.X.X.XXX.X.XXX.XXXXX.X.X.X.X.XXX.X.XXXXX.X.XXXXX.XXXXXXXXXXXXX.X.X.X.XXX.XXXXX.X.X.XXX.X.XXX
X.X.X.X.X.X...X...X...X.......X.X.X.X...X.X...X.....X...X...X.........X.X.X.X.X...X...X.X.X.X...X.X.X
X.X.X.X.X.XXXXX.XXXXX.X.XXXXX.X.X.X.XXX.X.XXX.XXXXX.X.XXXXX.X.X.XXXXX.X.X.X.X.X.XXX.XXX.X.XXX.X.X.X.X
X...X...X.X.......X...X.X...X.X...X...X...X...X...X...X...X...X.X...X...X.X.X.X.X...X...X.....X.X.X.X
X.XXXXXXX.X.XXXXX.X.XXX.X.X.X.XXX.XXX.X.XXX.XXX.X.X.XXX.X.XXXXX.X.X.XXXXX.X.XXX.X.X.X.XXXXXXX.X.X.X.X
X...X...X.X...X...X...X.X.X.....X...X.X.....X...X.X.X...X...X.X.X.X...X...X.....X.X.......X...X.X.X.X
XXX.X.X.X.XXXXX.XXXXX.X.X.XXXXXXXXX.X.XXXXXXX.XXX.X.X.XXXXX.X.X.X.XXX.X.XXXXXXXXX.XXXXXXXXX.X.XXX.X.X
X.X.X.X.X.....X.....X.X.X.....X.....X.........X.X.X.X...X.X.X...X...X...X.......X.X.X.....X.X.X...X.X
X.X.X.XXXXXXX.X.XXX.X.X.X.XXXXX.XXXXXXXXXXXXXXX.X.XXXXX.X.X.XXXXXXX.XXXXXXXXXXX.X.X.X.XXX.X.X.X.XXX.X
X...X.X.......X...X...X.X.X.....X...............X.X.....X.X.........X...........X.X.X.X...X.X.X.X...X
X.XXX.X.XXXXXXXXX.XXXXX.X.X.XXXXX.XXXXX.XXXXXXX.X.X.XXXXX.XXXXXXXXXXX.XXX.XXX.XXX.X.X.X.XXX.XXX.XXX.X
X.X...X.........X...X...X.X...X.X.X...X.X...X...X...X...X.......X.......X.X...X.....X.X.....X...X...X
X.X.X.XXXXXXXXX.XXXXX.XXX.XXX.X.X.X.XXX.XXX.X.XXXXXXXXX.XXXXX.X.XXX.XXX.XXXXX.X.XXXXX.X.XXXXX.XXX.XXX
X...X.....X...X...X...X...X...X.X.X...X...X.X.........X.......X...X.X.X.....X.X.X...X.X.X.....X.X...X
X.XXXXXXX.X.X.XXX.X.XXXXX.X.XXX.X.X.X.XXX.X.XXXXXXXXX.X.XXXXXXXXX.X.X.XXXXX.XXX.X.X.X.XXX.XXXXX.X.X.X
X.X...X...X.X.....X.X...X.X.X...X.X.X...X.X.X.......X...X.X.....X.X.......X...X...X.X.....X.......X.X
X.X.X.XXXXX.XXXXXXX.X.X.X.X.XXX.X.X.X.XXX.X.XXX.X.XXXXXXX.X.X.X.X.X.XXXXXXXXX.XXXXX.XXXXXXXXXXXXXXX.X
X.X.X.....X.......X...X.X.X.....X.X.X.X...X.....X.......X...X.X.X.X.X...X.....X...X.X...X.......X...X
X.X.XXXXX.XXXXXXX.X.XXX.XXXXX.XXX.XXX.X.XXX.XXXXXXX.X.X.XXXXX.X.X.XXX.X.X.XXX.XXX.X.X.X.XXX.XXX.X.XXX
X.X.X...X.X...X...X...X.......X...X...X...X.X.X...X.X.X.......X.X.....X...X...X...X...X...X.X.X...X.X
X.X.XXX.X.X.X.X.XXXXXXX.XXXXXXX.XXX.X.XXX.X.X.X.X.XXX.XXXXXXXXXXXXXXXXXXXXX.XXX.XXXXXXXXX.X.X.XXX.X.X
X.X...X.....X.X.......X.......X.X...X...X.X.X.X.X...X.....................X.X.......X...X...X...X.X.X
XXXXX.XXXXXXX.X.XXXXX.XXXXXXXXX.X.XXX.XXX.X.X.X.XXX.XXXXXXX.XXXXXXXXXXX.X.X.XXXXXXX.X.X.XXXXX.XXX.X.X
X.....X.X.....X.....X...X.......X.X...X...X...X...X.X.....X...X.......X.X.X.........X.X.....X...X.X.X
X.XXXXX.X.XXXXXXXXXXXXX.X.XXXXXXX.X.XXX.X.XXXXXXX.X.X.XXX.XXX.X.XXXXX.X.X.XXXXX.XXXXX.XXX.XXX.X.X.X.X
X.....X.X...............X.........X...X.X.X...X.X.X...X.X.X.X.X.....X.X.X...X...X.....X.X.X...X...X.X
X.XXX.X.X.XXXXXXXXXXXXXXXXXXXXX.XXXXXXX.XXX.X.X.X.XXXXX.X.X.X.X.XXXXX.X.XXXXX.XXX.XXXXX.X.X.XXXXXXX.X
X...X.X...X.........X.......X...X...X...X...X.....X.....X.X...X.X.....X.......X...X.....X.X.X.......X
XXX.X.X.XXX.XXXXXXX.X.X.XXXXX.XXX.X.X.XXX.XXXXXXXXX.X.XXX.XXX.XXX.XXXXXXXXXXXXX.XXX.XXX.X.X.X.XXXXX.X
X...X.X...X.X.X...X...X.....X...X.X.X...X.X.........X...X...X.....X...X...X...X.X.....X.X.X.X.X.....X
X.XXX.XXXXX.X.X.X.XXXXXXXXX.X.XXX.X.X.X.X.X.XXXXXXXXXXX.XXX.X.XXXXX.X.X.X.X.X.X.XXXXX.X.X.X.X.XXX.XXX
X...X.....X.X...X...X.....X...X...X.X.X.....X.......X...X.X.X...X...X.X.X.X.X...X.....X.X.X.X...X...X
XXXXXXXXX.X.X.XXXXX.XXX.X.XXXXX.XXX.XXXXXXXXX.XXX.X.X.XXX.X.X.XXX.XXX.X.X.X.X.XXX.XXXXX.X.X.XXX.XXX.X
X.........X...X.........X.....X.X.......X...X.X.X.X.X.....X.X.X.....X...X...X.....X.....X.X...X.X...X
X.XXXXXXXXXXXXX.XXXXXXXXXXX.XXX.XXXXXXX.X.X.X.X.X.XXXXXXX.X.XXX.XXXXXXXXXXXXXXXXXXX.XXXXX.XXX.X.XXXXX
X.X.........X...X...X.....X...X...X...X.X.X.X...X.....X...X.X...X.......X.X...X.........X...X.X.....X
X.X.XXXXX.XXX.XXX.XXX.XXX.XXXXXXX.X.X.X.X.XXXXX.XXX.X.X.XXX.X.XXX.XXXXX.X.X.X.XXX.XXXXX.XXX.X.XXX.X.X
X...X...X.....X...X...X.X.X.......X.X.X.X.X...X...X.X.X.X.X.X.X.....X.X...X.X...X.X...X...X.X...X.X.X
X.XXXXX.XXXXXXXXX.X.XXX.X.XXXXX.XXX.X.X.X.X.X.X.XXX.XXX.X.X.X.XXXXX.X.XXX.X.XXX.X.X.X.XXX.X.XXX.XXX.X
X.........X.......X.X.....X.....X...X.X.X.X.X...X...X.....X.X.X.....X.....X.X...X.X.X...X.X.X...X...X
XXXXXXXXX.X.XXXXXXX.X.XXXXX.XXXXX.XXX.X.X.X.XXXXX.XXX.XXXXX.X.X.XXXXX.XXXXX.X.XXXXX.XXX.XXX.X.XXX.X.X
X.......X...X.....X.X.X.....X...X.X.X...X.X.X...X.....X.....X.X...X.....X...X.....X.X.......X.X...X.X
X.XXX.XXXXX.X.XXXXX.X.X.XXXXXXX.X.X.XXXXX.X.XXX.XXXXXXX.X.XXX.XXX.XXXXXXX.XXXXXXX.X.XXXXXXX.X.X.XXX.X
X.X...X...X.X.X.....X.X.X.......X.X.X.......X.......X...X.X...X...X.......X...X.....X.....X.X...X.X.X
X.XXXXX.X.X.X.X.XXXXX.X.X.X.XXX.X.X.X.XXXXXXX.XXXXX.X.XXXXX.XXX.X.X.XXXXX.X.X.XXXXXXX.XXX.X.XXXXX.X.X
X.....X.X...X.X...X...X.X.X.X...X.X...........X.....X.X.........X.X.X.....X.X...........X.X.......X.X
X.XXX.X.XXXXX.XXX.XXX.X.XXX.XXXXX.XXXXX.XXXXXXXXXXXXX.X.XXXXXXXXXXX.XXX.XXX.XXXXXXXXXXXXX.XXXXXXX.X.X
X.X.X.X.....X...X...X.X...X.X.......X...X.....X.....X.....X.....X.....X...X.X...X...X.....X.......X.X
X.X.X.XXXXX.XXX.XXX.X.XXX.X.X.XXXXX.XXXXX.X.X.X.XXX.X.XXXXX.XXX.XXXXX.X.XXX.X.XXX.X.X.XXXXX.XXXXXXX.X
X.X.X.....X.X.....X.X.....X.X...X.X.......X.X...X...X.X.....X.X.....X.X.X.....X...X.X...X.........X.X
X.X.XXX.XXX.X.XXX.X.XXXXXXX.XXX.X.XXXXX.XXXXXXXXX.XXXXX.XXXXX.XXXXX.X.XXX.XXXXX.XXX.XXX.X.XXXXXXXXX.X
X.....X.X...X.X...X.....X.X.......X...X.X.....X...X...X.....X...........X.X.X...X.......X.X.......X.X
XXXXXXX.X.X.XXX.XXXXXXX.X.X.XXXXXXX.X.X.X.XXX.XXX.X.X.X.XXX.X.XXXXXXXXXXX.X.X.XXX.XXXXXXX.X.XXXXX.X.X
X.....X...X.....X...X...X...X.X.....X.X.X...X...X.X.X.X...X.X.X.....X.....X.X.X...X.....X.X.X...X.X.X
X.XXX.XXXXXXXXX.XXX.X.XXX.XXX.X.XXXXX.XXXXX.XXX.X.X.X.XXXXX.XXX.XXX.X.XXXXX.X.XXXXX.XXX.X.X.X.XXX.X.X
X.X.....X...X.......X.X.X...X.X.X...X.........X.X.X.X...X.X...X...X...X...X.X.......X...X.X...X.X...X
X.XXXXX.X.X.XXXXXXXXX.X.XXX.X.X.X.X.XXXXXXXXXXX.X.X.XXX.X.XXX.XXX.XXXXX.XXX.XXXXXXXXX.XXXXXXX.X.XXXXX
X...X...X.X.....X...X.X.......X.X.X.......X.....X...X.......X.X...X...X.......X.X...X.......X.X...X.X
X.X.XXX.X.XXXXX.X.X.X.X.XXXXXXX.X.XXX.XXX.X.XXXXX.XXXXXXXXX.X.X.XXXXX.XXXXXXX.X.X.X.XXXXXXX.X.XXX.X.X
X.X...X...X...X.X.X.X.X.X.....X.X.X...X...X.X...X.X...X...X...X.X...X.....X...X...X.....X...X...X...X
XXXXX.XXXXX.XXX.X.X.X.X.X.XXX.X.X.X.XXX.XXX.X.X.XXX.X.X.X.XXX.X.X.X.X.XXX.X.XXX.XXX.X.XXX.XXXXX.X.X.X
X.....X...........X...X...X...X.X.X.X.X...X.X.X.....X.X.X.X.X.X...X...X...X...X...X.X.X...X...X...X.X
X.XXXXX.XXXXXXXXXXXXXXXXXXX.XXX.XXX.X.X.XXX.X.XXXXXXX.XXX.X.X.XXXXXXXXX.XXXXX.XXX.X.XXX.X.X.X.XXXXX.X
X.....X.........X.......X...X...X...X...X...X.X...X.X.X...X.X...X.X...X.X.......X.X...X.X.X.X.....X.X
X.XXX.XXX.XXXXXXX.XXXXX.XXXXX.XXXXX.X.XXX.X.X.X.X.X.X.X.XXX.XXX.X.X.XXX.X.X.XXXXX.XXX.X.XXX.XXX.XXX.X
X.X.X.X...X.......X.X...X...X.X.X...X...X.X.X.X.X.X.X.X.......X.X.X...X.X.X.X.....X...X.....X.X...X.X
X.X.X.XXXXX.XXXXXXX.X.XXX.X.X.X.X.X.X.XXX.XXX.X.X.X.X.XXX.XXXXX.X.XXX.X.X.XXX.XXXXX.XXXXXXXXX.XXX.X.X
X.X.X.......X.....X.X.....X.X...X.X.X...X.X...X.X...X...X.............X.X.....X...X.............X.X.X
X.X.XXXXXXXXX.X.X.X.XXXXXXX.XXX.XXX.XXX.X.X.XXX.XXXXXXX.XXXXXXXXXXXXX.X.XXX.XXX.X.XXXXXXX.XXX.XXX.X.X
X.X...X.....X.X.X...X.....X...X.X...X.X.X.X...X.......X.......X...X...X...X...X.X.X.....X...X...X...X
X.XXX.XXX.X.XXX.XXX.X.XXXXXXX.X.X.XXX.X.X.XXX.XXXXX.XXXXXXX.X.X.X.X.XXXXX.XXX.X.XXX.XXX.X.X.XXXXXXXXX
X...X...X.X...X.X...X...X.....X.X.X...X.X...X.....X.......X.X.X.X.X.X...X...X...X...X.X.X.X...X.....X
XXX.X.X.XXX.X.X.X.XXX.X.X.XXXXX.X.X.XXX.X.XXXXXXX.XXXXX.XXXXX.X.X.X.X.X.XXX.XXX.X.XXX.X.XXXXX.X.XXX.X
X.X...X...X.X.X.X.X...X.X...X...X.X.....X.......X.......X...X.X.X.....X...X.X...X.X...X.....X...X...X
X.XXXXXXX.X.X.X.X.XXXXX.XXX.X.XXX.X.XXXXXXXXX.X.XXXXX.XXX.X.X.X.XXXXX.XXXXX.X.XXX.XXX.XXXXX.XXXXX.X.X
X.......X...X...X...X.....X.X.....X...X.....X.X.X.....X...X...X.X.X...X.....X...X...X.........X...X.X
XXXXX.XXXXXXXXXXXXX.X.XXXXX.XXXXXXXXX.X.XXX.X.XXX.XXXXX.XXXXXXX.X.X.XXX.XXXXX.XXXXX.XXX.XXXXX.X.XXX.X
X...X.............X.X.X.......X.......X...X.X...X...X.X.X.....X...X.X...X...X.X...X...X.X...X.X.X...X
X.X.XXX.XXX.XXXXX.X.X.X.X.XXXXX.XXXXXXX.XXX.XXX.XXX.X.X.X.XXX.X.XXXXX.XXX.XXX.X.X.X.X.XXX.X.X.X.XXX.X
X.X.....X...X...X.X...X.X...X...X...X...X.....X...X.X.X...X...X.X.....X.X.....X.X.X.X.....X.X...X.X.X
X.XXX.XXXXXXX.X.XXXXX.X.XXX.X.XXX.X.XXXXX.XXX.X.XXX.X.XXXXX.XXX.X.XXXXX.X.XXXXX.X.XXXXXXXXX.XXXXX.X.X
X...X.X.......X...X...X.X...X.X...X.....X.X...X...X.X.....X.X...X.....X.......X.X.....X...X.X.....X.X
X.X.XXX.XXXXXXXXX.X.XXX.X.XXX.X.XXXXXXX.X.XXXXXXX.X.XXXXX.X.X.XXXXXXX.X.XXXXXXX.XXXXX.X.X.X.X.XXXXX.X
X.X...X.....X.....X...X.X.X...X.X...X.....X.......X...X...X.X.X.....X.X.X.....X.X.....X.X.X.X.X.....X
XXXXX.XXX.XXX.XXXXXXX.X.XXX.XXX.X.X.XXXXX.X.XXX.XXXXX.X.XXX.X.X.XXXXX.XXX.XXX.X.XXX.XXX.X.X.X.X.XXXXX
X.......X.X...X.......X...X...X...X...X...X.X...X.....X...X.X...X.....X...X...X...X.....X...X.X...X.X
X.XXX.XXX.X.X.X.XXXXXXXXX.XXX.XXX.XXX.X.XXX.XXXXX.XXXXXXX.X.XXXXX.XXXXX.XXX.XXXXX.XXXXXXXXXXX.XXX.X.X
X.X...X...X.X.X.....X...X.X...X...X...X.X.X.......X...X...X.X.....X.X.....X.....X.X.X...........X...X
X.XXXXX.XXX.XXXXXXX.XXX.X.X.X.XXXXX.XXX.X.XXXXXXX.X.X.X.X.X.X.XXXXX.XXXXX.XXXXX.X.X.X.XXX.XXXXXXX.X.X
X.........X.............X...X.......X...........X...X...X.X...............X.......X.....X.........X.X
XXXXXXXXXXXXXXXXXXXXXXXXXXXXXXXXXXXXXXXXXXXXXXXXXXXXXXXXXXXXXXXXXXXXXXXXXXXXXXXXXXXXXXXXXXXXXXXXXXXXX
